######################.###########################
#................................................#
#.###################...########################.#
#.#..............#..............#..............#.#
#.#.############.#...#######....#.############.#.#
#.#.#..........#.#...#.....#....#.#..........#.#.#
#.#............#.#.....#####......#............#.#
#.#.##.##..##.##.#.....#...#....#.#.#..##..#.#.#.#
#.#.#..........#.#.......#......#.#..........#.#.#
#.#.##.##..##.##.#.....#######..#.#.#..##..#.#.#.#
#.#............#.#........##....#.#............#.#
#.#.#..........#.#....###....#..#.#..........#.#.#
#.##############.#..............#.##############.#
#................#..###....###..#................#
#................#..............#................#
#.##############.#..............#.##############.#
#.#.#..........#.#...#..#..#....#.#..........#.#.#
#.#............#.#..............#.#............#.#
#.#.##.##..##.##.#......#..#....#.#.#..##.##.#.#.#
#.#.#..........#.#..............#.#..........#.#.#
#.#.##.##..##.##.#......#..#....#.#.#..##.##.#.#.#
#.#............#.#......####......#............#.#
#.#.#..........#.#.........#....#.#..........#.#.#
#.#.############.#....######....#.############.#.#
#.#..............#..............#..............#.#
#.##############################################.#
#........................@.......................#
##################################################