#####################.########################
#............................................#
#.##################...#####################.#
#.#..............#......##...#.............#.#
#.#.############.#..######...#.###########.#.#
#.#.#..........#.#..#....#...#.#.........#.#.#
#.#............#.#....####.....#...........#.#
#.#.##.##..##.##.#....#..#...#.#.#..#..#.#.#.#
#.#.#..........#.#..#...#....#.#.........#.#.#
#.#.##.##..##.##.#....######.#.#.#..#..#.#.#.#
#.#............#.#..#....#...#.#...........#.#
#.#.#..........#.#...###...#.#.#.........#.#.#
#.##############.#...........#.#############.#
#................#.###...###.#...............#
#.##############.#.....##....#.#############.#
#.#............#.#...#..#..#.#.#...........#.#
#.#.##.##..##.##.#.....#.#...#.#.#..#.##.#.#.#
#.#.#..........#.#...#.......#.#.........#.#.#
#.#.##.##..##.##.#.....#.#...#.#.#..#.##.#.#.#
#.#............#.#....#..#.....#...........#.#
#.#.############.#...#####...#.###########.#.#
#.#..............#...........#.............#.#
#.##########################################.#
#......................@.....................#
##############################################