#####################.########################
#............................................#
#.##################...#####################.#
#.#..............#...........#.............#.#
#.#.############.#..######...#.###########.#.#
#.#.#..........#.#..#....#...#.#.........#.#.#
#.#............#.#....####.....#...........#.#
#.#.##.##..##.##.#....#..#...#.#.#..#..#.#.#.#
#.#.#..........#.#......#....#.#.........#.#.#
#.#.##.##..##.##.#....######.#.#.#..#..#.#.#.#
#.#............#.#.......#...#.#...........#.#
#.#.#..........#.#...###...#.#.#.........#.#.#
#.##############.#...........#.#############.#
#................#.###...###.#...............#
#.##############.#...........#.#############.#
#.#............#.#..%........#.#...........#.#
#.#.##.##..##.##.#.....#.#...#.#.#..#.##.#.#.#
#.#.#..........#.#...........#.#.........#.#.#
#.#.##.##..##.##.#.....#.#...#.#.#..#.##.#.#.#
#.#............#.#.....###.....#...........#.#
#.#.############.#...#####...#.###########.#.#
#.#..............#...........#.............#.#
#.##########################################.#
#......................@.....................#
##############################################